aafiaakram.projects@gmail.com	Aafia Akram	2. Book/Movie Recommendation System (Web Development Track)
abhilasnayak25@gmail.com	Abhilas Nayak	1. AI Tutoring System (Machine Learning Track)
abhilasnayak25@gmail.com	Abhilas Nayak	2. Book/Movie Recommendation System (Web Development Track)
authenticahel@gmail.com	Adrija Karmakar 	1. AI Tutoring System (Machine Learning Track)
adrikabanerje019@gmail.com	Adrika Banerjee	2. Book/Movie Recommendation System (Web Development Track)
aishanimallick100@gmail.com	Aishani Mallick 	2. Book/Movie Recommendation System (Web Development Track)
aishanimallick100@gmail.com	Aishani Mallick 	2. Book/Movie Recommendation System (Web Development Track)
akashchakraborty694@gmail.com	Akash Chakraborty	2. Book/Movie Recommendation System (Web Development Track)
maityakash543@gmail.com	Akash Maity 	1. AI Tutoring System (Machine Learning Track)
ajha20079@gmail.com	Aman Jha	1. AI Tutoring System (Machine Learning Track)
raiaman9123@gmail.com	Aman Kumar Rai	2. Book/Movie Recommendation System (Web Development Track)
ananya.chatterje06@gmail.com	Ananya Chatterjee 	2. Book/Movie Recommendation System (Web Development Track)
oniani507@gmail.com	Aninda Mondal	2. Book/Movie Recommendation System (Web Development Track)
sarkaranindita279@gmail.com	Anindita Sarkar 	1. AI Tutoring System (Machine Learning Track)
dasanisha2104@gmail.com	Anisha Das	1. AI Tutoring System (Machine Learning Track)
ankitaad12345@gmail.com	Ankita Adhya 	2. Book/Movie Recommendation System (Web Development Track)
ankitaad12345@gmail.com	Ankita Adhya 	2. Book/Movie Recommendation System (Web Development Track)
ankit01hazra@gmail.com	Ankita Hazra 	2. Book/Movie Recommendation System (Web Development Track)
arijitchowdhury115@gmail.com	Arijit Chowdhury 	2. Book/Movie Recommendation System (Web Development Track)
aritrasinha2400@gmail.com	Aritra Sinha	1. AI Tutoring System (Machine Learning Track)
arpanm820@gmail.com	Arpan Mondal	2. Book/Movie Recommendation System (Web Development Track)
arpitsinghchas1234@gmail.com	Arpit Singh	1. AI Tutoring System (Machine Learning Track)
avikhalder2020@gmail.com	Avik Halder 	2. Book/Movie Recommendation System (Web Development Track)
barshamishra33322@gmail.com	Barsha Mishra	1. AI Tutoring System (Machine Learning Track)
barshamishra33322@gmail.com	Barsha Mishra 	1. AI Tutoring System (Machine Learning Track)
pauldebanshu73@gmail.com	Debanshu Paul	1. AI Tutoring System (Machine Learning Track)
dipmalika.db2006@gmail.com	Dipmalika Banerjee 	2. Book/Movie Recommendation System (Web Development Track)
shawdisha001@gmail.com	Disha Shaw	2. Book/Movie Recommendation System (Web Development Track)
rajdivyanshu86@gmail.com	Divyanshu Raj	1. AI Tutoring System (Machine Learning Track)
pauleshani06@gmail.com	Eshani Paul 	1. AI Tutoring System (Machine Learning Track)
gouravd719@gmail.com	Gourav Das	2. Book/Movie Recommendation System (Web Development Track)
ishu99055@gmail.com	Ishita Bose 	2. Book/Movie Recommendation System (Web Development Track)
dasjyotishman37@gmail.com	Jyotishman Das	1. AI Tutoring System (Machine Learning Track)
karmakarlisa4@gmail.com	Lisa Karmakar 	1. AI Tutoring System (Machine Learning Track)
ghoshmaithili5@gmail.com	Maithili Ghosh 	2. Book/Movie Recommendation System (Web Development Track)
maushamprasad97@gmail.com	mausham prasad	1. AI Tutoring System (Machine Learning Track)
salmanbiswas20143@gmail.com	Md Salman Biswas 	2. Book/Movie Recommendation System (Web Development Track)
mzoheb161@gmail.com	Mohammed Zoheb 	2. Book/Movie Recommendation System (Web Development Track)
moulibanik123@gmail.com	Mouli Banik 	1. AI Tutoring System (Machine Learning Track)
		
nyyadav2004@gmail.com	Neha Yadav 	1. AI Tutoring System (Machine Learning Track)
nikhisingh86@gmail.com	Nikhil singh	1. AI Tutoring System (Machine Learning Track)
mystical.nikita16@gmail.com	Nikita Rani Pradhan 	2. Book/Movie Recommendation System (Web Development Track)
iamkumarom.edu@gmail.com	Om Kumar	1. AI Tutoring System (Machine Learning Track)
pallabibiswas4002@gmail.com	Pallabi Biswas	2. Book/Movie Recommendation System (Web Development Track)
prathamjaiswal204@gmail.com	Pratham Jaiswal	2. Book/Movie Recommendation System (Web Development Track)
pratishthagupta512@gmail.com	Pratishtha Gupta	2. Book/Movie Recommendation System (Web Development Track)
sujatadhar32198@gmail.com	Prativa Dhar	2. Book/Movie Recommendation System (Web Development Track)
mahapatrapreksha@gmail.com	Preksha Mahapatra	2. Book/Movie Recommendation System (Web Development Track)
prithwishsahoo2021@gmail.com	Prithwish Sahoo	1. AI Tutoring System (Machine Learning Track)
puskarsaha3@gmail.com	Puskar Saha	2. Book/Movie Recommendation System (Web Development Track)
puspita27122005@gmail.com	puspita Maji	2. Book/Movie Recommendation System (Web Development Track)
shekhawat7449@gmail.com	Rahul Singh 	2. Book/Movie Recommendation System (Web Development Track)
dasrakhi2d@gmail.com	Rakesh Das 	1. AI Tutoring System (Machine Learning Track)
rudrraaa@proton.me	Rudra Pratap Singh	1. AI Tutoring System (Machine Learning Track)
saikatmaji2006@gmail.com	Saikat Maji	1. AI Tutoring System (Machine Learning Track)
sjha49816@gmail.com	Sakshi Jha 	1. AI Tutoring System (Machine Learning Track)
sjha49816@gmail.com	Sakshi Jha 	1. AI Tutoring System (Machine Learning Track)
sanapal483@gmail.com	Sana Pal	1. AI Tutoring System (Machine Learning Track)
sananditas09@gmail.com	Sanandita Saha 	1. AI Tutoring System (Machine Learning Track)
satishjalan9163@gmail.com	Satish jalan	2. Book/Movie Recommendation System (Web Development Track)
sbsaumya2@gmail.com	Saumya Bag	1. AI Tutoring System (Machine Learning Track)
saunomibala@gmail.com	Saunomi Bala	2. Book/Movie Recommendation System (Web Development Track)
rsayan570@gmail.com	Sayan Roy 	2. Book/Movie Recommendation System (Web Development Track)
sayani7806@gmail.com	Sayani Rana	1. AI Tutoring System (Machine Learning Track)
sidsayantani2020@gmail.com	Sayantani Siddhanta	1. AI Tutoring System (Machine Learning Track)
jimsayokook07@gmail.com	Sayoni Chakraborty 	2. Book/Movie Recommendation System (Web Development Track)
shekharshubham5112002@gmail.com	Shekhar shubham thakur 	1. AI Tutoring System (Machine Learning Track)
deyshreya728@gmail.com	Shreya Dey 	1. AI Tutoring System (Machine Learning Track)
shreya987ghosh@gmail.com	Shreya Ghosh	1. AI Tutoring System (Machine Learning Track)
meshrisjha@gmail.com	Shrishti Jha 	1. AI Tutoring System (Machine Learning Track)
afifhassan78@gmail.com	SK AFIF HASSAN 	1. AI Tutoring System (Machine Learning Track)
deysmriti53@gmail.com	Smriti Dey 	1. AI Tutoring System (Machine Learning Track)
snehakarmakaroff@gmail.com	Sneha Karmakar 	2. Book/Movie Recommendation System (Web Development Track)
k.sneha042006@gmail.com	Sneha kumari 	1. AI Tutoring System (Machine Learning Track)
snehamandal1212@gmail.com	Sneha Mandal	2. Book/Movie Recommendation System (Web Development Track)
sngdhmstr@gmail.com	Snigdha Mistry 	2. Book/Movie Recommendation System (Web Development Track)
roychowdhurysoham2004@gmail.com	Soham roy chowdhury 	2. Book/Movie Recommendation System (Web Development Track)
sohomchatterjee07@gmail.com	Sohom Chatterjee 	2. Book/Movie Recommendation System (Web Development Track)
soumick2005@gmail.com	Soumick Mondal	1. AI Tutoring System (Machine Learning Track)
souravpatra915@gmail.com	Sourav Patra	2. Book/Movie Recommendation System (Web Development Track)
souriksasmal35@gmail.com	Sourik Sasmal	2. Book/Movie Recommendation System (Web Development Track)
srijudutta2005@gmail.com	Srijita Dutta	1. AI Tutoring System (Machine Learning Track)
srijonisarkar935@gmail.com	Srijoni Sarkar	1. AI Tutoring System (Machine Learning Track)
stuti.cghs.karmakar@gmail.com	STUTI KARMAKAR	1. AI Tutoring System (Machine Learning Track)
subhojitb67@gmail.com	Subhajit Banerjee 	2. Book/Movie Recommendation System (Web Development Track)
SubhrajitMukherjee04@gmail.com	SUBHRAJIT MUKHERJEE 	1. AI Tutoring System (Machine Learning Track)
sudipadhara1806@gmail.com	Sudipa Dhara 	2. Book/Movie Recommendation System (Web Development Track)
sharmasumitkumar2903@gmail.com	Sumit Kumar Sharma	1. AI Tutoring System (Machine Learning Track)
swastikabarman21@gmail.com	Swastika Barman 	1. AI Tutoring System (Machine Learning Track)
swastikabhaumick@gmail.com	Swastika Bhaumick 	1. AI Tutoring System (Machine Learning Track)
tarunbinaydas@gmail.com	Tarun Binay Das 	1. AI Tutoring System (Machine Learning Track)
vaishnavisingh112004@gmail.com	Vaishnavi Singh 	1. AI Tutoring System (Machine Learning Track)